Mercedes
{
    Petronas : Petronas Gas Berhad (6033.KL)
    CrowdStrike : CrowdStrike Holdings, Inc. (CRWD) 
    TeamViewer: TeamViewer SE (TMV) 
    UBS: UBS Group AG (UBS)
    Snapdragon: QUALCOMM Incorporated (QCOM)
    IWC Schaffhausen : Compagnie Financiere Richemont SA (CFR.SW)
    Hewlett Packard Enterprise : HPE 
    AMD : Advanced Micro Devices (AMD)
    The Ritz Carlton : Marriot International, Inc (MAR)
    Sherwin Williams : The Sherwin - Williams (SHW)
    SAP : SAP (SAP SE)
    WhatsApp : Meta Platforms (META)
    Luminar : Luminar Technologies, Inc. (LAZR)
}

Redbull{

    Armor All -> Energizer Holdings, Inc (ENR)
    EA Sports -> Electronic Arts Inc. (EA)
    Heineken -> Heineken N.V (HEINY)
    TAG Heuer -> LVMH (LVMUY)
    Visa -> Visa Inc. (V)
    YETI -> YETI Holdings, Inc. (YETI)
    AT&T -> AT&T (T)
    CDW -> CDW Corporation (CDW)
    Esso -> Exxon Mobil Corporation (XOM)
    Mobil 1 -> Exxon Mobil Corporation (XOM)
    Siemens -> Siemens AG (SIE.SG)
    Zoom -> Zoom Communications (ZM)

}